#############
#  #     #@&#
# %#S % %#@@#
# % % # % @@#
#     %   @@#
#############