0000#####0000000000
0000#   #0000000000
0000#%  #0000000000
00###  %##000000000
00#  % % #000000000
### # ## #000######
#   # ## #####  @@#
# %  %          @@#
##### ### #S##  @@#
0000#     #########
0000#######00000000